................@...
........@...........
....................
......@........@....
.....@.....@....@@..
....................
....A...............
.......@......@.....
....................
..........@.........
.........@..@.......
....................
@...................
....................
..............@..@..
.....@@.@......@@...
.....@..............
....@...............
.........@..........
.............@......
